11111
1PC11
11011
1EC11
11111
