11111111111111111111
1CCCCCCCCCCCCCCCCCC1
1C0111000000111000C1
1C1P00000001000100C1
1C0111000001000100C1
1C0000100001000100C1
1C011100000E111000C1
1CCCCCCCCCCCCCCCCCC1
11111111111111111111