11111111
1C000001
1E000001
1P000001
11000001
11111111