111111111111111
1E0000010000001
101001010010001
101001001010101
1P0001000C001C1
100010011000111
111111111111111