11111111111111111111
1CCCCCCCCCCCCCCCCCC1
1C0011100000111000C1
1C01P0000001000100C1
1C0011100001000100C1
1C0000010001000100C1
1C001110000E111000C1
1CCCCCCCCCCCCCCCCCC1
11111111111111111111