111111111111111111111
1010110C1111E10000101
101011000011010001001
10011011P010011110001
101000000000011000101
111111111111111111111