11111111111111111111111111111111
100000010110P1101101101101000111
11010011001110011110111100100001
100C1010001000001000001000010001
10010011100010010101010110000011
11111111111111111111111111111111