11111111111111111111111111111111
10000010111001101101100101000011
11010011001E1100111101C111001001
10000C000100000100010000P0100001
10010011100101010100110001001001
11111111111111111111111111111111